00000000000000000000000000000001000010000000000000000000000000000000
00000000000000000000000000000001000010000000000000000000000000000000
00000000000000000000000000000001000010000000000000000000000000000000
00000000000000000000000000000001000010000000000000000000000000000000
00000000000000000000000000000001000010000000000000000000000000000000
00000000000000000000000000000001000010000000000000000000000000000000
00000000000000000000000000111111000011111100000000000000000000000000
00000000000000000000000000100000000000000100000000000000000000000000
00000000000000000000000000100000000000000100000000000000000000000000
00000000000000000000000000100000000000000100000000000000000000000000
00000000000000000000000000100000000000000100000000000000000000000000
00000000000000011111111111100000000000000111111111111000000000000000
00000000000000000000000000000000000000000000000000000000000000000000
00000000000000000000000000000000000000000000000000000000000000000000
00000000000000000000000000000000000000000000000000000000000000000000
00000000000000000000000000000000000000000000000000000000000000000000
00000000000000011111111111100000000000000111111111111000000000000000
00000000000000000000000000100000000000000100000000000000000000000000
00000000000000000000000000100000000000000100000000000000000000000000
00000000000000000000000000100000000000000100000000000000000000000000
00000000000000000000000000100000000000000100000000000000000000000000
00000000000000000000000000111111000011111100000000000000000000000000
00000000000000000000000000000001000010000000000000000000000000000000
00000000000000000000000000000001000010000000000000000000000000000000
00000000000000000000000000000001000010000000000000000000000000000000
00000000000000000000000000000001000010000000000000000000000000000000
00000000000000000000000000000001000010000000000000000000000000000000
00000000000000000000000000000001000010000000000000000000000000000000